0,0,0,0,0,0,0,0,0,0,0,0,0,0,0,0,2,0,0,0,0,0,0,0,0,0,0,0,0,0,0
0,0,0,0,0,0,0,0,0,0,0,0,0,0,0,0,1,5,5,0,0,0,0,0,0,0,0,0,0,0,0
0,0,0,0,1,1,1,1,0,0,0,0,0,0,0,0,1,1,1,1,1,1,1,0,0,0,0,0,0,0,0
0,0,0,0,1,0,0,1,1,5,0,0,5,5,1,1,1,1,1,0,0,0,1,0,0,0,0,0,0,0,0
0,0,0,0,1,0,0,1,1,1,1,1,1,1,1,1,8,5,5,0,0,5,1,0,0,0,0,0,0,0,0
0,0,0,5,1,5,0,5,8,5,0,0,0,0,0,0,0,0,0,0,0,5,1,1,1,0,0,0,0,0,0
0,0,0,8,1,5,0,0,0,0,0,0,0,0,5,1,5,5,0,0,0,0,0,0,1,0,0,0,0,0,0
0,0,0,0,1,0,0,0,0,0,0,0,0,0,5,1,1,5,0,0,0,0,0,0,1,0,0,0,0,0,0
0,0,0,0,1,0,0,0,5,8,5,0,0,0,1,1,1,1,1,1,1,1,1,1,1,0,0,0,0,0,0
0,0,0,0,1,0,0,0,5,1,5,0,0,0,0,0,0,0,0,0,1,1,0,0,0,0,0,0,0,0,0
0,0,2,1,1,1,1,0,1,1,1,0,0,0,0,0,0,0,0,0,1,1,0,0,0,0,0,0,0,0,0
0,0,0,5,1,1,1,0,1,1,8,0,0,0,0,0,0,0,0,0,0,0,0,0,0,0,0,0,0,0,0
0,0,0,5,5,1,1,1,1,1,8,0,5,5,0,0,0,0,0,0,0,1,1,2,0,0,0,0,0,0,0
0,0,0,0,0,0,0,0,1,1,1,0,1,5,0,0,0,5,5,0,0,1,1,0,0,0,0,0,0,0,0
0,0,0,0,0,0,0,0,1,1,1,1,1,1,0,0,0,1,1,1,1,1,1,0,0,0,0,0,0,0,0
0,0,0,0,0,0,0,0,0,0,0,0,1,1,1,1,1,1,1,0,0,1,1,0,0,0,0,0,0,0,0
0,0,0,0,0,0,0,0,0,0,0,0,8,1,0,0,0,5,1,0,0,0,0,0,0,0,0,0,0,0,0
0,0,0,5,8,1,1,8,1,1,0,0,0,0,0,0,0,5,1,0,0,0,0,0,0,0,0,0,0,0,0
0,0,0,5,8,5,8,1,0,1,0,0,0,0,0,8,8,1,1,0,0,0,0,0,0,0,0,0,0,0,0
0,0,0,0,0,0,0,0,0,1,0,0,0,0,0,5,1,1,1,1,1,1,1,0,0,0,0,0,0,0,0
0,0,0,0,0,0,0,0,1,1,1,0,0,0,0,0,1,0,0,0,0,5,8,0,0,0,0,0,0,0,0
0,0,0,0,0,1,1,1,1,1,1,0,0,1,1,1,1,0,0,0,0,5,5,0,0,0,0,0,0,0,0
0,0,0,0,0,1,0,0,0,1,0,0,0,1,0,0,0,0,0,0,0,0,0,0,0,0,0,0,0,0,0
0,0,0,0,0,1,0,0,0,1,1,1,1,1,0,0,0,0,0,0,0,0,0,0,0,0,0,0,0,0,0
0,0,0,0,0,1,0,0,0,0,0,0,0,0,0,0,0,0,0,0,0,0,0,0,0,0,0,0,0,0,0
0,0,0,0,5,1,1,1,0,0,0,0,0,0,0,5,1,5,1,0,0,0,0,0,0,0,0,0,0,0,0
0,0,0,0,5,1,1,1,1,1,1,0,0,0,0,5,1,1,8,0,0,0,0,0,0,0,0,0,0,0,0
0,0,0,0,8,5,5,5,0,0,1,0,0,0,0,0,1,0,0,0,0,0,0,0,0,0,0,0,0,0,0
0,0,0,0,0,0,0,0,0,1,1,1,1,1,1,1,1,0,0,0,0,0,0,0,0,0,0,0,0,0,0
0,0,0,0,0,0,0,0,0,1,1,1,0,0,0,0,0,0,0,0,0,0,0,0,0,0,0,0,0,0,0
0,0,0,0,0,0,0,0,0,0,2,0,0,0,0,0,0,0,0,0,0,0,0,0,0,0,0,0,0,0,0
