0,0,0,0,0,0,0,0,0,0,0,0,0,0,0,0,0,0,0,0,0,0,0,0,0,0,0,0,0,0,0
0,0,0,0,0,0,0,0,0,0,0,0,0,0,0,0,0,0,0,0,0,0,0,0,0,0,0,0,0,0,0
0,0,0,0,0,0,0,0,0,0,2,0,0,0,5,1,8,1,8,1,1,5,1,1,5,5,1,8,0,0,0
0,0,0,0,0,0,0,0,0,0,1,0,0,0,8,14,14,14,14,14,14,14,14,14,14,14,14,1,0,0,0
0,0,0,0,0,0,0,8,1,1,1,0,0,0,1,14,14,14,14,14,14,14,14,14,14,14,14,1,0,0,0
0,0,0,0,0,0,0,1,1,8,1,0,0,0,1,1,1,5,1,1,1,5,1,1,1,1,1,5,0,0,0
0,0,0,0,0,0,0,0,1,0,0,0,0,0,0,0,1,0,0,0,0,0,0,0,0,0,1,0,0,0,0
0,0,0,0,0,0,0,0,1,0,0,0,0,0,0,0,1,0,0,0,0,0,0,0,0,0,1,0,0,0,0
0,5,1,5,1,0,0,0,1,1,1,8,8,0,0,8,1,1,0,0,0,0,0,5,5,1,1,1,0,0,0
0,5,1,1,1,1,1,1,1,1,1,1,8,0,0,8,1,8,0,0,0,0,0,1,1,1,1,1,0,0,0
0,8,1,1,1,0,0,0,7,1,5,1,7,0,0,1,1,1,0,0,0,0,0,1,1,5,5,5,0,0,0
0,1,1,1,5,0,0,0,1,1,1,1,1,0,0,1,1,5,0,0,0,0,0,0,1,0,0,0,0,0,0
2,1,1,1,5,0,0,0,1,1,1,1,1,1,1,1,1,5,0,0,0,0,0,0,1,0,0,0,0,0,0
0,0,0,1,0,0,0,0,7,1,5,1,7,0,0,0,0,0,0,0,0,0,0,0,1,1,8,0,0,0,0
0,0,0,1,1,0,0,0,1,1,1,1,1,0,0,0,0,0,0,0,0,0,0,0,0,5,1,0,0,0,0
0,0,0,0,1,0,0,0,1,1,1,1,1,0,0,0,0,0,0,0,0,0,0,0,0,5,1,0,0,0,0
0,0,0,0,1,0,0,0,7,1,5,1,7,0,0,5,5,8,1,5,1,5,0,0,0,5,1,0,0,0,0
0,0,0,0,1,0,0,0,1,1,1,1,1,1,1,1,1,1,1,1,8,1,0,0,0,0,1,0,0,0,0
0,0,0,0,1,1,1,1,1,1,1,1,1,0,0,5,1,5,1,1,1,5,0,0,0,0,1,0,0,0,0
0,0,0,0,1,0,0,0,7,1,5,1,7,0,0,0,0,0,0,1,0,0,0,0,0,0,1,1,8,8,0
0,0,0,0,1,0,0,0,1,1,1,1,1,0,0,0,0,0,0,1,0,0,0,0,0,0,1,1,1,1,2
0,0,0,0,1,0,0,0,0,0,0,0,0,0,0,5,1,5,1,1,5,0,0,0,0,0,1,1,1,8,0
0,0,0,0,1,0,0,0,0,0,0,0,0,0,0,1,1,1,1,1,1,0,0,0,0,1,1,0,0,0,0
0,0,0,0,1,1,1,5,0,0,0,0,0,0,0,5,1,1,5,1,5,0,0,0,0,1,0,0,0,0,0
0,0,0,0,1,1,1,11,0,0,0,0,0,0,0,0,1,0,0,0,0,0,0,0,0,1,8,0,0,0,0
0,0,0,0,8,8,1,5,0,0,5,5,8,8,1,0,1,0,0,0,0,5,5,1,1,1,1,0,0,0,0
0,0,0,0,0,0,0,0,0,0,8,1,1,1,1,1,1,0,0,0,0,8,1,1,1,1,5,0,0,0,0
0,0,0,0,0,0,0,0,0,0,1,1,1,1,5,0,0,0,0,0,0,1,1,5,8,8,5,0,0,0,0
0,0,0,0,0,0,0,0,0,0,0,0,1,0,0,0,0,0,0,0,0,0,0,0,0,0,0,0,0,0,0
0,0,0,0,0,0,0,0,0,0,0,0,2,0,0,0,0,0,0,0,0,0,0,0,0,0,0,0,0,0,0
0,0,0,0,0,0,0,0,0,0,0,0,0,0,0,0,0,0,0,0,0,0,0,0,0,0,0,0,0,0,0
