0,0,0,0,0,0,0,0,0,2,0,0,0,0,0,0,0,0,0,0,0,0,0,0,0,0,0,0,0,0,0,0,0,0,0,0,0,0,0,0,0,0,0,0,0,0,0,0,0,0,0,0,0,0,0,0,0
0,0,0,0,0,0,0,1,1,1,1,1,22,1,1,1,1,1,0,1,1,16,16,23,0,0,0,0,0,0,0,0,0,1,16,16,16,23,0,0,0,0,0,0,0,0,0,0,0,0,0,0,0,0,0,0,0
0,0,0,0,0,0,0,21,0,0,0,1,0,0,0,0,0,1,0,1,16,16,16,16,0,0,0,0,0,0,0,0,0,1,16,16,16,16,0,0,0,0,0,0,0,0,0,0,0,0,0,0,0,0,0,0,0
0,10,1,1,1,1,1,1,0,0,0,1,0,0,0,0,0,1,1,1,1,1,16,16,0,1,1,1,1,1,1,1,22,1,1,1,16,16,0,0,0,0,0,1,1,1,1,1,1,1,1,1,1,1,1,10,0
0,1,1,1,1,1,1,1,0,0,0,1,0,0,0,0,0,0,0,0,0,0,0,0,0,1,0,0,0,0,0,0,0,0,0,1,0,0,0,0,0,0,0,1,0,0,0,1,0,1,1,1,1,1,1,1,0
0,1,1,1,1,1,1,1,1,1,0,1,1,1,1,1,1,1,1,1,22,1,1,1,1,1,0,1,1,1,0,0,0,0,0,1,0,0,0,0,0,0,0,1,0,0,0,1,0,1,1,1,1,1,1,1,0
0,1,1,1,1,1,1,1,0,1,0,0,0,0,0,0,0,0,0,21,0,0,0,0,0,0,0,22,0,22,0,0,0,0,0,22,0,0,0,0,0,0,0,21,0,0,0,1,0,1,1,1,1,1,1,1,0
0,1,1,1,1,1,1,1,0,1,1,1,22,1,1,1,1,1,1,1,1,1,1,10,1,1,1,1,0,1,1,1,1,1,1,1,1,1,1,1,1,1,1,1,0,1,1,1,0,1,1,1,1,1,1,1,0
0,1,1,1,1,1,1,1,0,0,0,0,0,1,1,1,1,1,1,1,1,1,1,1,1,1,1,1,0,1,1,1,1,1,1,1,1,1,1,1,1,1,1,1,0,1,0,0,0,1,1,1,1,1,1,1,0
0,1,1,1,1,1,1,1,21,1,1,1,0,1,1,1,1,1,1,1,1,1,1,1,1,1,1,1,0,1,1,1,1,1,1,1,1,1,1,1,1,1,1,1,0,1,0,0,0,1,1,1,1,1,1,1,2
0,1,1,1,1,1,1,1,0,0,0,1,0,1,1,14,14,1,1,14,1,1,1,1,1,1,1,1,0,1,1,1,1,1,1,1,1,14,1,1,14,14,1,1,0,1,0,0,0,1,1,1,1,1,1,1,0
0,1,1,1,1,1,1,1,0,0,0,1,0,1,14,14,14,14,1,14,1,1,1,1,1,1,1,1,0,1,1,1,1,1,1,1,1,14,1,14,14,14,14,1,0,1,0,0,0,1,1,1,1,1,1,1,0
0,1,1,1,1,1,1,1,0,0,0,1,0,1,14,14,14,14,14,14,14,14,14,14,14,14,14,1,0,1,14,14,14,14,14,14,14,14,14,14,14,14,14,1,0,1,0,0,0,1,1,1,1,1,1,1,0
0,1,1,1,1,1,1,1,0,0,0,1,21,1,14,14,14,14,1,14,1,1,1,1,1,1,1,1,0,1,1,1,1,1,1,1,1,14,1,14,14,14,14,1,0,1,1,1,0,1,1,1,1,1,1,1,0
0,21,0,0,0,0,0,0,0,0,0,0,0,1,1,14,14,1,1,14,1,1,1,1,1,1,1,1,0,1,1,1,1,1,1,1,1,14,1,1,14,14,1,1,0,0,0,1,0,22,0,0,0,0,0,0,0
0,1,22,1,1,1,1,1,1,1,1,1,0,1,1,1,1,1,1,1,1,1,1,1,1,1,1,1,0,1,1,1,1,1,1,1,1,1,1,1,1,1,1,1,0,0,0,1,0,1,0,0,0,0,0,0,0
0,1,0,0,0,0,0,0,0,0,0,1,0,1,1,1,1,1,1,1,1,1,1,1,1,1,1,1,0,1,1,1,1,1,1,1,1,1,1,1,1,1,1,1,0,0,0,1,0,1,0,0,0,0,0,0,0
0,1,0,1,1,1,1,1,1,1,0,1,0,1,1,1,1,1,1,1,1,1,1,1,1,1,1,1,1,1,1,1,1,1,1,1,1,1,1,1,1,10,1,1,0,0,0,1,0,1,1,1,1,1,0,0,0
0,1,0,22,0,0,0,22,0,0,0,22,0,21,0,0,0,0,0,0,0,0,0,0,0,0,0,0,0,0,0,0,0,0,0,0,0,0,0,0,0,0,0,0,0,0,0,21,0,0,0,0,0,1,0,0,0
0,1,1,1,0,1,1,1,1,1,1,1,1,1,0,0,0,0,0,0,0,0,0,0,0,0,0,0,0,0,0,0,0,0,0,0,0,0,0,0,0,1,22,1,1,1,1,1,1,1,1,1,0,1,0,0,0
0,0,0,0,0,1,1,1,1,1,1,1,1,1,0,0,0,0,0,0,0,0,0,0,0,0,0,0,0,0,0,0,0,0,0,0,0,0,0,0,0,1,0,1,1,1,1,1,1,1,1,1,0,1,0,0,0
0,0,0,0,0,1,1,1,1,1,1,1,1,1,0,0,0,0,0,0,0,0,0,0,0,0,0,0,0,0,0,0,0,0,0,0,0,0,0,0,0,1,0,1,1,1,1,1,1,1,1,1,0,1,0,0,0
0,0,0,0,0,1,1,1,1,1,1,1,1,1,0,0,0,0,0,0,0,0,0,0,0,0,0,0,0,0,0,0,0,0,0,0,0,0,0,0,0,22,0,1,1,1,1,1,1,1,1,1,0,1,0,0,0
0,0,0,0,0,1,1,1,1,1,1,1,1,1,22,16,16,16,0,0,0,0,0,0,0,0,0,0,0,0,0,0,0,0,0,0,0,0,0,16,16,16,0,1,1,1,1,1,1,1,1,1,0,1,0,0,0
0,0,0,0,0,1,1,1,1,1,1,1,1,1,0,16,23,16,0,0,0,0,0,0,0,0,0,0,0,0,0,0,0,0,0,0,0,0,0,16,23,16,0,1,1,1,1,1,1,1,1,1,0,1,0,0,0
0,0,0,0,0,1,1,1,1,1,1,1,1,1,0,16,16,16,0,0,0,0,0,0,0,0,0,0,0,0,0,0,0,0,0,0,0,0,0,16,16,16,22,1,1,1,1,1,1,1,1,1,0,1,0,0,0
0,0,0,0,0,1,10,1,1,1,1,1,1,1,0,22,0,22,0,0,0,0,0,0,0,0,0,0,0,0,0,0,0,0,0,0,0,0,0,0,0,0,0,1,1,1,1,1,1,1,10,1,0,1,0,0,0
0,1,1,1,21,1,1,1,1,1,1,1,1,1,0,1,22,1,0,0,0,0,0,0,0,0,0,0,0,0,0,0,0,0,0,0,0,0,0,0,0,0,0,1,1,1,1,1,1,1,1,1,22,1,0,0,0
0,1,0,0,0,0,0,0,0,0,0,0,0,21,0,1,0,0,0,0,0,0,0,0,0,0,0,0,0,0,0,0,0,0,0,0,0,0,0,0,0,0,0,0,0,0,0,21,0,0,0,0,0,1,0,0,0
0,1,0,0,0,1,1,1,1,1,1,1,1,1,0,1,0,0,0,0,0,0,0,0,0,0,0,0,0,0,0,0,0,0,0,0,0,0,0,0,0,0,0,1,1,1,1,1,1,1,1,1,0,1,0,0,0
0,1,0,0,0,1,1,1,1,1,1,1,1,1,0,22,0,0,0,0,0,0,0,0,0,0,0,0,0,0,0,0,0,0,0,0,0,0,0,0,0,0,0,1,1,1,1,1,1,1,1,1,0,1,0,0,0
0,1,0,0,0,1,1,1,1,1,1,1,1,1,0,16,16,23,0,0,0,0,0,0,0,0,0,0,0,0,0,0,0,0,0,0,0,0,0,23,16,16,22,1,1,1,1,1,1,1,1,1,22,1,0,0,0
0,1,0,0,0,1,1,1,1,1,1,1,1,1,0,16,16,16,0,0,0,0,0,0,0,0,0,0,0,0,0,0,0,0,0,0,0,0,0,16,16,16,0,1,1,1,1,1,1,1,1,1,0,1,0,0,0
0,1,0,0,0,1,1,1,1,1,1,1,1,1,0,16,16,16,0,0,0,0,0,0,0,0,0,0,0,0,0,0,0,0,0,0,0,0,0,16,16,16,0,1,1,1,1,1,1,1,1,1,0,1,1,1,0
0,1,0,0,0,1,1,1,1,1,1,1,1,1,0,0,0,0,0,0,0,0,0,0,0,0,0,0,0,0,0,0,0,0,0,0,0,0,0,0,0,15,0,1,1,1,1,1,1,1,1,1,0,0,0,1,0
0,1,0,0,0,1,1,1,1,1,1,1,1,1,22,1,0,0,0,0,0,0,0,0,0,0,0,0,0,0,0,0,0,0,0,0,0,0,0,0,0,1,0,1,1,1,1,1,1,1,1,1,0,0,0,1,0
0,1,0,0,0,1,1,1,1,1,1,1,10,1,0,1,0,0,0,0,0,0,0,0,0,0,0,0,0,0,0,0,0,0,0,0,0,0,0,0,0,1,0,1,10,1,1,1,1,1,1,1,0,0,0,1,0
0,1,0,0,0,1,1,1,1,1,1,1,1,1,0,1,0,0,0,0,0,0,0,0,0,0,0,0,0,0,0,0,0,0,0,0,0,0,0,0,0,1,21,1,1,1,1,1,1,1,1,1,0,0,0,1,0
0,1,0,0,0,0,0,0,0,0,0,0,0,0,0,22,0,0,0,0,0,0,0,0,0,0,0,0,0,0,0,0,0,0,0,0,0,0,0,0,0,0,0,0,0,0,0,21,0,0,0,0,0,0,0,1,0
0,1,0,0,0,0,0,0,0,0,0,1,21,1,1,1,1,1,1,1,1,1,1,1,1,1,1,1,21,1,1,1,1,1,1,1,1,1,1,1,1,1,1,10,0,0,0,1,22,1,1,1,0,0,0,1,0
0,1,0,0,0,0,0,0,0,0,0,1,0,1,1,1,1,1,1,1,1,1,1,1,1,1,1,1,0,1,1,1,1,1,1,1,1,1,1,1,1,1,1,1,0,0,0,1,0,0,0,1,0,0,0,1,0
0,1,0,0,0,1,1,1,1,1,1,1,0,1,1,1,1,1,1,1,1,1,1,1,1,1,1,1,0,1,1,1,1,1,1,1,1,1,1,1,1,1,1,1,0,0,0,1,0,0,0,1,0,1,1,1,0
0,21,0,0,0,21,0,0,0,0,0,0,0,1,1,14,14,1,1,14,1,1,1,1,1,1,1,1,0,1,1,1,1,1,1,1,1,14,1,1,14,14,1,1,0,0,0,1,0,0,0,22,0,22,0,0,0
0,1,1,1,1,1,1,1,22,1,1,1,22,1,14,14,14,14,1,14,1,1,1,1,1,1,1,1,0,1,1,1,1,1,1,1,1,14,1,14,14,14,14,1,0,0,0,1,21,1,1,1,1,1,1,1,0
0,1,1,1,1,1,1,1,0,1,0,0,0,1,14,14,14,14,14,14,14,14,14,14,14,14,14,1,0,1,14,14,14,14,14,14,14,14,14,14,14,14,14,1,0,0,0,0,0,1,1,1,1,1,1,1,0
0,1,1,1,1,1,1,1,0,1,1,1,0,1,14,14,14,14,1,14,1,1,1,1,1,1,1,1,0,1,1,1,1,1,1,1,1,14,1,14,14,14,14,1,21,1,1,1,0,1,1,1,1,1,1,1,0
0,1,1,1,1,1,1,1,0,0,0,1,0,1,1,14,14,1,1,14,1,1,1,1,1,1,1,1,0,1,1,1,1,1,1,1,1,14,1,1,14,14,1,1,0,0,0,1,0,1,1,1,1,1,1,1,0
0,1,1,1,1,1,1,1,0,1,0,1,0,1,1,1,1,1,1,1,1,1,1,1,1,1,1,1,0,1,1,1,1,1,1,1,1,1,1,1,1,1,1,1,0,0,0,1,0,1,1,1,1,1,1,1,0
0,1,1,1,1,1,1,1,0,1,0,1,0,1,1,1,1,1,1,1,1,1,1,1,1,1,1,1,0,1,1,1,1,1,1,1,1,1,1,1,1,1,1,1,0,0,0,1,0,1,1,1,1,1,1,1,0
0,1,1,1,1,1,1,1,0,1,0,1,0,1,10,1,1,1,1,1,1,1,1,1,1,1,1,1,0,1,1,1,1,1,1,1,1,1,1,1,1,1,1,1,21,1,1,1,0,1,1,1,1,1,1,1,0
2,1,1,1,1,1,1,1,0,1,0,1,0,22,0,0,0,0,0,0,0,0,0,22,0,0,0,21,0,0,0,21,0,0,0,0,0,0,0,0,0,1,0,21,0,0,0,0,0,1,1,1,1,1,1,1,0
0,1,1,1,1,1,1,1,0,1,0,1,0,1,0,0,0,1,1,1,1,1,1,1,0,0,0,1,0,0,0,1,1,1,1,1,1,1,1,1,1,1,0,1,0,0,0,0,0,1,1,1,1,1,1,1,0
0,1,1,1,1,1,1,1,0,1,0,1,0,1,0,0,0,1,0,0,0,0,0,0,0,0,0,1,0,0,0,0,0,0,0,0,0,22,0,0,0,0,0,1,0,0,0,0,0,1,1,1,1,1,1,1,0
0,10,1,1,1,1,1,1,0,1,22,1,22,1,0,0,0,1,0,1,1,1,1,1,21,1,1,1,0,0,0,1,1,16,16,1,1,1,0,0,0,0,0,1,1,1,1,1,0,1,1,1,1,1,1,10,0
0,0,0,0,0,15,0,0,0,0,0,0,0,0,0,0,0,1,0,1,1,1,1,1,0,0,0,0,0,0,0,1,0,16,16,16,16,1,0,0,0,0,0,0,0,0,0,1,0,0,0,21,0,0,0,0,0
0,0,0,0,0,1,1,1,1,1,1,1,1,1,1,1,1,1,0,1,1,1,1,1,22,1,1,1,1,1,1,1,0,23,16,1,16,16,0,0,0,0,0,0,0,0,0,1,1,1,1,1,0,0,0,0,0
0,0,0,0,0,0,0,0,0,0,0,0,0,0,0,0,0,0,0,0,0,0,0,0,0,0,0,0,0,0,0,0,0,0,0,0,0,0,0,0,0,0,0,0,0,0,0,0,0,2,0,0,0,0,0,0,0
