0,0,0,0,0,0,0,0,0,0,0,0,0,0,0,2,0,0,0,0,0,0,0,0,0,0,0,0,0,0,0
0,8,8,8,8,14,14,14,14,14,14,1,1,1,1,1,0,1,1,1,1,0,7,7,7,1,9,9,9,9,0
0,8,8,8,8,14,14,14,14,14,14,1,14,14,14,1,0,1,1,1,1,0,7,1,1,1,9,9,11,9,0
0,0,0,0,0,0,0,0,0,0,1,1,14,14,14,1,0,1,1,1,1,0,7,1,9,9,9,9,9,9,0
0,8,8,8,8,1,9,1,1,1,1,1,14,14,14,1,0,0,0,0,9,0,7,1,9,9,9,9,9,9,0
0,8,1,1,1,1,0,1,1,1,1,1,14,14,14,1,0,8,8,0,1,15,1,9,9,1,9,9,1,1,0
0,8,8,8,1,1,0,1,1,1,1,1,1,1,1,1,0,8,8,0,1,15,1,9,9,9,9,1,1,7,0
0,0,0,0,0,1,0,1,1,0,0,0,0,0,0,0,0,8,8,0,1,15,9,9,9,9,9,1,1,7,0
0,8,8,1,1,1,0,1,1,1,1,9,1,1,1,1,1,1,1,0,1,0,1,1,1,1,7,7,7,7,0
0,8,1,1,1,1,0,1,1,1,1,0,0,0,0,0,0,1,1,0,1,0,0,12,0,0,0,0,0,0,0
0,8,1,0,0,0,0,1,1,1,1,1,1,1,8,8,0,1,1,0,1,1,1,1,1,1,1,8,8,8,0
0,1,1,1,1,1,1,1,1,1,1,1,1,1,8,1,0,1,1,0,9,0,0,0,0,0,0,8,8,8,0
0,14,14,14,14,14,14,1,0,0,0,0,0,0,1,1,0,1,1,0,1,1,1,1,1,1,0,1,8,8,0
0,14,14,14,14,14,14,1,0,1,1,9,1,1,1,1,0,1,1,1,1,1,1,1,1,1,0,1,8,8,0
0,0,0,0,14,14,14,1,0,1,1,0,0,0,0,0,0,1,0,0,0,0,0,0,0,0,0,1,1,1,0
2,14,14,14,14,14,14,1,0,1,1,0,1,1,1,1,1,1,1,1,1,1,1,1,9,1,1,1,1,1,2
0,14,14,14,14,14,0,0,0,1,1,0,1,14,14,14,14,14,0,1,1,1,1,9,1,9,1,1,1,1,0
0,14,14,14,14,14,1,1,1,1,1,0,1,14,14,14,14,14,0,1,1,1,1,1,9,1,1,1,0,1,0
0,0,0,0,14,14,1,1,1,1,1,1,1,1,0,0,0,0,0,8,8,0,0,0,0,1,1,1,0,9,0
0,6,6,0,1,1,1,1,1,1,1,1,1,1,1,1,1,1,0,8,8,0,1,1,1,1,1,1,0,9,0
0,6,6,0,9,0,0,0,0,0,0,1,1,1,1,1,1,1,0,8,8,0,1,14,14,14,14,1,0,9,0
0,6,6,0,1,0,9,9,1,1,1,1,1,1,1,1,1,1,9,1,1,0,1,14,14,14,14,1,0,9,0
0,6,6,0,1,0,9,9,1,1,1,0,0,0,0,0,0,0,0,0,0,0,1,14,14,14,14,1,0,0,0
0,1,1,0,1,0,9,9,1,1,1,1,1,1,9,1,1,1,1,1,1,1,1,14,14,14,14,1,0,9,0
0,1,1,0,1,0,0,0,0,0,1,1,1,1,9,1,1,1,1,1,1,1,1,14,14,14,14,1,0,9,0
0,1,1,0,1,1,1,1,1,0,1,14,14,1,0,1,14,14,14,1,1,1,1,1,1,1,1,1,0,9,0
0,15,15,0,1,1,1,1,1,0,1,14,14,1,0,1,14,14,14,1,0,0,0,0,0,0,0,0,0,9,0
0,1,1,0,0,0,0,0,0,0,1,14,14,1,0,1,14,14,14,1,1,1,1,1,1,1,1,1,1,1,0
0,1,1,1,1,1,1,1,1,1,1,14,14,1,0,1,14,14,14,1,1,1,1,1,1,1,1,1,1,1,0
0,1,1,1,1,1,1,1,1,1,1,1,1,1,0,1,1,1,1,1,1,1,1,1,1,8,8,8,8,8,0
0,0,0,0,0,0,0,0,0,0,0,0,0,0,0,2,0,0,0,0,0,0,0,0,0,0,0,0,0,0,0
