0,0,0,0,0,0,0,0,0,0,0,0,0,0,0,2,0,0,0,0,0,0,0,0,0,0,0,0,0,0,0
0,1,1,1,1,1,1,3,3,1,1,1,1,1,1,1,1,1,1,1,1,1,15,8,8,8,8,8,8,1,0
0,1,1,1,3,3,3,3,1,1,1,1,1,1,1,1,1,1,1,1,1,1,15,1,1,8,8,8,8,1,0
0,1,1,3,3,3,4,4,4,1,1,1,1,1,1,1,1,1,1,1,1,1,15,1,1,1,8,1,8,1,0
0,1,1,3,1,4,4,4,4,1,1,1,1,1,1,1,1,1,1,1,1,1,15,1,1,1,8,8,8,8,0
0,1,1,3,3,4,4,4,4,1,1,1,1,1,1,1,1,1,1,1,1,1,15,15,15,1,15,15,15,15,0
0,1,1,1,1,4,4,4,4,1,1,1,1,1,1,1,1,1,1,1,1,1,1,1,1,1,1,1,1,1,0
0,1,1,1,1,1,1,1,1,1,1,1,1,1,1,1,1,1,1,3,3,3,1,1,1,1,1,1,1,1,0
0,1,1,1,1,1,1,1,1,1,1,1,1,1,1,1,1,3,3,3,3,4,4,1,1,1,1,1,1,1,0
0,1,1,1,1,15,15,15,1,15,15,15,1,1,1,1,1,3,1,4,4,4,4,4,1,1,1,1,1,1,0
0,1,1,1,1,15,1,8,1,8,8,15,1,1,1,1,1,1,3,4,4,4,4,4,1,1,1,1,1,1,0
0,1,1,1,1,15,8,8,8,8,1,15,1,1,1,1,3,3,3,4,4,4,4,1,1,1,1,1,1,1,0
0,1,1,1,1,15,1,8,8,8,8,15,1,1,1,1,1,1,4,4,4,4,4,1,1,1,1,1,1,1,0
0,1,1,1,1,15,1,8,8,8,8,15,1,1,1,1,1,1,1,1,1,1,1,1,1,1,1,1,1,1,0
0,1,1,1,1,15,1,8,1,1,1,15,1,1,1,1,1,1,1,1,1,1,1,1,1,1,1,1,1,1,0
2,1,1,1,1,15,15,15,15,15,15,15,1,1,1,1,1,1,1,1,1,1,1,1,1,1,1,1,1,1,2
0,1,1,1,1,1,1,1,1,1,1,1,1,1,1,1,1,1,1,1,1,1,1,1,1,1,1,1,1,1,0
0,1,1,1,1,1,1,1,1,1,1,1,1,1,1,1,1,1,1,1,1,1,1,1,1,1,1,1,1,1,0
0,1,1,1,1,1,3,3,3,1,1,1,1,1,1,1,1,1,1,1,1,1,1,1,1,1,1,1,1,1,0
0,1,1,1,1,3,3,4,1,3,3,1,1,1,15,15,15,15,15,15,15,1,1,1,1,1,1,1,1,1,0
0,1,1,1,3,3,3,4,4,3,3,3,1,1,15,1,1,8,8,8,15,1,1,1,1,3,3,1,1,1,0
0,1,1,1,1,4,4,4,4,4,3,1,1,1,15,8,1,8,8,8,15,1,1,1,3,3,1,1,1,1,0
0,1,1,1,1,3,4,4,4,4,1,3,1,1,15,8,8,8,8,8,1,1,1,3,1,4,3,1,1,1,0
0,1,1,1,1,4,4,4,4,4,4,1,1,1,15,1,8,8,8,8,15,1,3,3,3,4,1,3,1,1,0
0,1,1,1,1,1,1,4,4,4,1,1,1,1,15,1,1,8,8,8,15,1,3,1,4,4,4,4,1,1,0
0,15,15,1,15,15,15,15,1,1,1,1,1,1,15,15,15,15,15,15,15,1,1,4,4,4,4,4,1,1,0
0,15,1,8,8,1,1,15,1,1,1,1,1,1,1,1,1,1,1,1,1,1,4,4,4,4,4,4,1,1,0
0,15,1,8,8,1,1,15,1,1,1,1,1,1,1,1,1,1,1,1,1,1,1,4,4,4,4,4,1,1,0
0,15,8,8,8,8,8,15,1,1,1,1,1,1,1,1,1,1,1,1,1,1,1,1,1,1,4,1,1,1,0
0,15,1,8,8,8,8,15,1,1,1,1,1,1,1,1,1,1,1,1,1,1,1,1,1,1,1,1,1,1,0
0,0,0,0,0,0,0,0,0,0,0,0,0,0,0,2,0,0,0,0,0,0,0,0,0,0,0,0,0,0,0
